1. Arts the Beatdoctor - Transitions = Mood: Deep, Melancholic | Time: Night | Energy: Calm, Dreamy
2. Kanye West - MBDTF = Mood: Euphoric, Angry | Time: Night | Energy: Energetic, Groovy
3. Kendrick Lamar - good kid mAAd city = Mood: Deep, Sad | Time: Night | Energy: Groovy, Dark
4. Apollo Brown - Clouds = Mood: Melancholic, Nostalgic | Time: Sunset | Energy: Calm, Cozy
5. Wu-Tang Clan - 36 Chambers = Mood: Angry, Euphoric | Time: Night | Energy: Aggressive, Groovy
6. Кровосток - Студень = Mood: Eerie, Deep | Time: Night | Energy: Dark, Weird
7. Method Man & Redman - Blackout! = Mood: Euphoric, Angry | Time: Night | Energy: Energetic, Groovy
8. Snoop Dogg - Doggystyle = Mood: Euphoric | Time: Day | Energy: Groovy, Cozy
9. Nas - Illmatic = Mood: Deep, Melancholic | Time: Night | Energy: Groovy, Dark
10. Black Star - Black Star = Mood: Euphoric, Deep | Time: Day | Energy: Groovy, Cozy
11. Army of the Pharaohs - Ritual of Battle = Mood: Angry | Time: Night | Energy: Aggressive, Energetic
12. Run the Jewels - RTJ2 = Mood: Angry, Euphoric | Time: Day | Energy: Aggressive, Energetic
13. A$AP Rocky - LiveLoveA$AP = Mood: Trippy, Melancholic | Time: Night | Energy: Dreamy, Groovy
14. ATCQ - Low End Theory = Mood: Euphoric | Time: Day | Energy: Groovy, Cozy
15. Доброе Чувство - Птицу ЕМЪ = Mood: Eerie, Deep | Time: Night | Energy: Dark, Weird
16. Михей и Джуманджи - Сука любовь = Mood: Sad, Nostalgic | Time: Sunset | Energy: Cozy, Calm
17. Mos Def - Black on Both Sides = Mood: Euphoric, Deep | Time: Day | Energy: Groovy, Energetic
18. Mobb Deep - The Infamous = Mood: Angry, Deep | Time: Night | Energy: Dark, Groovy
19. Notorious B.I.G. - Ready to Die = Mood: Deep, Euphoric | Time: Night | Energy: Groovy, Dark
20. Антоха МС - От всей души = Mood: Euphoric, Nostalgic | Time: Day | Energy: Cozy, Groovy
21. Kid Cudi - Man on the Moon = Mood: Trippy, Sad | Time: Night | Energy: Dreamy, Calm
22. Coldcut - True Skool = Mood: Euphoric | Time: Day | Energy: Groovy, Energetic
23. Madlib - Shades of Blue = Mood: Melancholic, Deep | Time: Late Night | Energy: Calm, Cozy
24. Kaytranada - 99.9% = Mood: Euphoric | Time: Night | Energy: Groovy, Energetic
25. Run DMC - Raising Hell = Mood: Euphoric, Angry | Time: Day | Energy: Energetic, Aggressive
26. OutKast - Stankonia = Mood: Euphoric, Trippy | Time: Day | Energy: Groovy, Energetic
27. Eminem - The Eminem Show = Mood: Angry | Time: Day | Energy: Aggressive, Energetic
28. MF Doom - Operation Doomsday = Mood: Trippy, Deep | Time: Sunset | Energy: Groovy, Weird
29. Big L - Lifestylez = Mood: Angry | Time: Night | Energy: Aggressive, Groovy
30. 50 Cent - Get Rich or Die Tryin' = Mood: Angry, Euphoric | Time: Day | Energy: Aggressive, Groovy
31. Warren G - Regulate G Funk Era = Mood: Euphoric | Time: Sunset | Energy: Groovy, Cozy
32. Cypress Hill - Cypress Hill = Mood: Trippy, Angry | Time: Night | Energy: Groovy, Dark
33. CunninLynguists - A Piece of Strange = Mood: Deep, Sad | Time: Night | Energy: Dreamy, Calm
34. Yo La Tengo - I Can Hear the Heart = Mood: Melancholic, Nostalgic | Time: Sunset | Energy: Cozy, Dreamy
35. Animal Collective - Merriweather = Mood: Euphoric, Trippy | Time: Day | Energy: Energetic, Dreamy
36. The Avalanches - Since I Left You = Mood: Euphoric, Nostalgic | Time: Day | Energy: Groovy, Energetic
37. Beach House - Bloom = Mood: Melancholic, Trippy | Time: Sunset | Energy: Dreamy, Calm
38. Chromatics - Kill for Love = Mood: Melancholic, Sad | Time: Night | Energy: Dark, Dreamy
39. Pulp - Different Class = Mood: Euphoric, Nostalgic | Time: Day | Energy: Groovy, Energetic
40. Elliott Smith - Either/Or = Mood: Sad, Melancholic | Time: Morning | Energy: Calm, Cozy
41. Swans - Children of God = Mood: Eerie, Deep | Time: Night | Energy: Aggressive, Dark
42. Spiritualized - Ladies and Gentlemen = Mood: Trippy, Euphoric | Time: Sunset | Energy: Dreamy, Energetic
43. Ride - Nowhere = Mood: Melancholic, Euphoric | Time: Day | Energy: Dreamy, Energetic
44. The Antlers - Hospice = Mood: Sad | Time: Night | Energy: Calm, Dark
45. Bon Iver - Bon Iver = Mood: Sad, Melancholic | Time: Morning | Energy: Calm, Cozy
46. The Magnetic Fields - 69 Love Songs = Mood: Melancholic, Nostalgic | Time: Sunset | Energy: Cozy, Calm
47. Pavement - Crooked Rain = Mood: Euphoric, Nostalgic | Time: Day | Energy: Cozy, Groovy
48. The National - Boxer = Mood: Sad, Melancholic | Time: Night | Energy: Calm, Dark
49. The Stone Roses - The Stone Roses = Mood: Euphoric | Time: Day | Energy: Groovy, Energetic
50. Acid House Kings - Sing Along = Mood: Euphoric, Nostalgic | Time: Morning | Energy: Cozy, Calm
51. Arcade Fire - The Suburbs = Mood: Nostalgic, Melancholic | Time: Sunset | Energy: Energetic, Cozy
52. Aztec Camera - High Land Hard Rain = Mood: Euphoric, Nostalgic | Time: Morning | Energy: Cozy, Energetic
53. Belle and Sebastian - If You're Feeling Sinister = Mood: Melancholic, Nostalgic | Time: Morning | Energy: Cozy, Calm
54. The Church - Starfish = Mood: Trippy, Melancholic | Time: Sunset | Energy: Dreamy, Calm
55. John Coltrane - Blue Train = Mood: Deep, Euphoric | Time: Night | Energy: Energetic, Groovy
56. Eels - Electro-Shock Blues = Mood: Sad, Eerie | Time: Night | Energy: Calm, Dark
57. Donald Fagen - The Nightfly = Mood: Nostalgic, Euphoric | Time: Late Night | Energy: Cozy, Groovy
58. Fleet Foxes - Fleet Foxes = Mood: Nostalgic, Melancholic | Time: Morning | Energy: Cozy, Calm
59. Foxygen - 21st Century Ambassadors = Mood: Euphoric, Trippy | Time: Day | Energy: Groovy, Weird
60. Girls - Father Son Holy Ghost = Mood: Sad, Nostalgic | Time: Sunset | Energy: Cozy, Calm
61. Grizzly Bear - Veckatimest = Mood: Melancholic, Deep | Time: Morning | Energy: Cozy, Dreamy
62. LCD Soundsystem - Sound of Silver = Mood: Euphoric, Melancholic | Time: Night | Energy: Groovy, Energetic
63. Liars - Liars = Mood: Eerie, Angry | Time: Night | Energy: Weird, Aggressive
64. Lightning Bolt - Wonderful Rainbow = Mood: Angry, Euphoric | Time: Day | Energy: Aggressive, Energetic
65. Magazine - Real Life = Mood: Eerie, Deep | Time: Night | Energy: Dark, Groovy
66. Modest Mouse - Lonesome Crowded West = Mood: Angry, Sad | Time: Night | Energy: Energetic, Dark
67. Purity Ring - Shrines = Mood: Trippy, Melancholic | Time: Night | Energy: Dreamy, Dark
68. Royal Blood - Royal Blood = Mood: Angry, Euphoric | Time: Day | Energy: Aggressive, Energetic
69. Savages - Silence Yourself = Mood: Angry, Eerie | Time: Night | Energy: Aggressive, Dark
70. Sisters of Mercy - First and Last and Always = Mood: Melancholic, Eerie | Time: Night | Energy: Dark, Groovy
71. Sixteen Horsepower - Low Estate = Mood: Eerie, Deep | Time: Sunset | Energy: Dark, Calm
72. The Soft Moon - The Soft Moon = Mood: Eerie, Trippy | Time: Night | Energy: Dark, Dreamy
73. Sonic Youth - Sister = Mood: Trippy, Angry | Time: Day | Energy: Energetic, Weird
74. Spiritual Front - Armageddon Gigolo = Mood: Melancholic, Eerie | Time: Night | Energy: Dark, Cozy
75. The Strokes - Is This It = Mood: Euphoric | Time: Day | Energy: Energetic, Groovy
76. Tallest Man on Earth - The Wild Hunt = Mood: Melancholic, Nostalgic | Time: Morning | Energy: Cozy, Calm
77. Tame Impala - Lonerism = Mood: Trippy, Melancholic | Time: Sunset | Energy: Dreamy, Groovy
78. GY!BE - Lift Yr Skinny Fists = Mood: Deep, Sad | Time: Sunset | Energy: Energetic, Dark
79. Television - Marquee Moon = Mood: Deep, Euphoric | Time: Night | Energy: Energetic, Groovy
80. Wire - Pink Flag = Mood: Angry, Euphoric | Time: Day | Energy: Energetic, Aggressive
Вывезу 100. Погнали:

81. Claps - Wreck = Mood: Angry, Eerie | Time: Night | Energy: Aggressive, Dark
82. The Fall - Perverted by Language = Mood: Angry, Eerie | Time: Day | Energy: Weird, Energetic
83. Interpol - Turn on the Bright Lights = Mood: Melancholic, Sad | Time: Night | Energy: Dark, Groovy
84. Killing Joke - Night Time = Mood: Angry, Eerie | Time: Night | Energy: Dark, Energetic
85. Liquid Liquid - Liquid Liquid = Mood: Euphoric, Trippy | Time: Night | Energy: Groovy, Energetic
86. Bark Psychosis - Hex = Mood: Deep, Melancholic | Time: Late Night | Energy: Dreamy, Calm
87. Bauhaus - In the Flat Field = Mood: Eerie, Angry | Time: Night | Energy: Dark, Aggressive
88. Liliput - Liliput = Mood: Euphoric, Angry | Time: Day | Energy: Weird, Energetic
89. Talking Heads - Remain in Light = Mood: Euphoric, Trippy | Time: Day | Energy: Groovy, Energetic
90. DIIV - Oshin = Mood: Melancholic, Trippy | Time: Sunset | Energy: Dreamy, Calm
91. Durutti Column - Return of the Durutti Column = Mood: Melancholic, Sad | Time: Morning | Energy: Calm, Cozy
92. Tortoise - Millions Now Living = Mood: Deep, Trippy | Time: Sunset | Energy: Calm, Groovy
93. toe - The Book About My Idle Plot = Mood: Euphoric, Melancholic | Time: Morning | Energy: Cozy, Energetic
94. Explosions in the Sky - The Earth Is Not a Cold Dead Place = Mood: Sad, Euphoric | Time: Sunset | Energy: Energetic, Dreamy
95. Lush - Split = Mood: Melancholic, Euphoric | Time: Day | Energy: Dreamy, Energetic
96. Pale Saints - Comforts of Madness = Mood: Melancholic, Trippy | Time: Sunset | Energy: Dreamy, Calm
97. You Slut! - Critical Meat = Mood: Euphoric, Angry | Time: Day | Energy: Energetic, Aggressive
98. If These Trees Could Talk - Above the Earth = Mood: Deep, Sad | Time: Sunset | Energy: Energetic, Dreamy
99. Velvet Underground & Nico = Mood: Eerie, Deep | Time: Night | Energy: Dark, Weird
100. Tom Waits - Mule Variations = Mood: Deep, Eerie | Time: Late Night | Energy: Dark, Weird
101. The Clash - London Calling = Mood: Angry, Euphoric | Time: Day | Energy: Energetic, Aggressive
102. King Crimson - In the Court = Mood: Deep, Eerie | Time: Night | Energy: Energetic, Weird
103. Atheist - Unquestionable Presence = Mood: Deep, Angry | Time: Day | Energy: Aggressive, Weird
104. Dire Straits - Dire Straits = Mood: Nostalgic, Melancholic | Time: Late Night | Energy: Cozy, Calm
105. At the Drive-In - Relationship of Command = Mood: Angry, Euphoric | Time: Day | Energy: Aggressive, Energetic
106. Sleep - Holy Mountain = Mood: Trippy, Deep | Time: Sunset | Energy: Aggressive, Dreamy
107. Iggy Pop - The Idiot = Mood: Eerie, Deep | Time: Night | Energy: Dark, Weird
108. Jeff Buckley - Grace = Mood: Sad, Deep | Time: Night | Energy: Calm, Energetic
109. Fleetwood Mac - Rumours = Mood: Nostalgic, Sad | Time: Sunset | Energy: Cozy, Groovy
110. Peter Gabriel - So = Mood: Euphoric, Deep | Time: Day | Energy: Energetic, Groovy
111. Cocteau Twins - Heaven or Las Vegas = Mood: Melancholic, Euphoric | Time: Sunset | Energy: Dreamy, Cozy
112. Massive Attack - Blue Lines = Mood: Deep, Melancholic | Time: Night | Energy: Groovy, Dark
113. Coil - Horse Rotorvator = Mood: Eerie, Deep | Time: Night | Energy: Dark, Weird
114. Nujabes - Metaphorical Music = Mood: Nostalgic, Melancholic | Time: Sunset | Energy: Cozy, Groovy
115. Clams Casino - Instrumentals = Mood: Trippy, Melancholic | Time: Night | Energy: Dreamy, Calm
116. Washed Out - Life of Leisure = Mood: Euphoric, Trippy | Time: Sunset | Energy: Dreamy, Cozy
117. Kraftwerk - Electric Cafe = Mood: Euphoric, Trippy | Time: Night | Energy: Groovy, Calm
118. Pet Shop Boys - Please = Mood: Euphoric, Melancholic | Time: Night | Energy: Groovy, Energetic
119. SBTRKT - SBTRKT = Mood: Euphoric, Deep | Time: Night | Energy: Groovy, Energetic
120. Emancipator - Safe in the Steep Cliffs = Mood: Melancholic, Nostalgic | Time: Morning | Energy: Calm, Cozy
121. Biosphere - Substrata = Mood: Deep, Eerie | Time: Night | Energy: Calm, Dreamy
122. Effective Force - Diamond Bullet = Mood: Euphoric, Deep | Time: Night | Energy: Groovy, Energetic
123. Venetian Snares - Rossz csillag = Mood: Sad, Eerie | Time: Night | Energy: Weird, Aggressive
124. The Caretaker - Everywhere at the End of Time = Mood: Sad, Eerie | Time: Late Night | Energy: Calm, Dark
125. Manuel Göttsching - E2-E4 = Mood: Trippy, Euphoric | Time: Sunset | Energy: Groovy, Dreamy
126. Midori Takada - Through the Looking Glass = Mood: Trippy, Deep | Time: Morning | Energy: Calm, Dreamy
127. Thievery Corporation - Sounds From The = Mood: Euphoric, Nostalgic | Time: Sunset | Energy: Groovy, Cozy
128. Todd Terje - It's Album Time = Mood: Euphoric | Time: Day | Energy: Groovy, Energetic
129. Depeche Mode - Black Celebration = Mood: Melancholic, Eerie | Time: Night | Energy: Dark, Groovy
130. The Knife - Silent Shout = Mood: Eerie, Angry | Time: Night | Energy: Dark, Energetic
131. Burial - Untrue = Mood: Sad, Melancholic | Time: Late Night | Energy: Dark, Dreamy
132. Brian Eno - Before and After Science = Mood: Trippy, Deep | Time: Morning | Energy: Calm, Dreamy
133. Caribou - Can't Do Without You = Mood: Euphoric, Melancholic | Time: Day | Energy: Groovy, Energetic
134. Alexander Robotnick - Problèmes d'Amour = Mood: Euphoric | Time: Night | Energy: Groovy, Energetic
135. D Train - Music = Mood: Euphoric | Time: Night | Energy: Groovy, Energetic
136. Yazoo - Upstairs at Eric's = Mood: Melancholic, Euphoric | Time: Night | Energy: Groovy, Dark
137. Arthur Russell - Love Is Overtaking Me = Mood: Melancholic, Nostalgic | Time: Sunset | Energy: Cozy, Calm
138. Metro Area - Metro Area = Mood: Euphoric | Time: Night | Energy: Groovy, Energetic
139. Bob Moses - Days Gone By = Mood: Euphoric, Deep | Time: Night | Energy: Groovy, Dreamy
140. DJ Shadow - Endtroducing = Mood: Deep, Melancholic | Time: Late Night | Energy: Groovy, Dreamy
141. Autechre - Amber = Mood: Deep, Trippy | Time: Night | Energy: Calm, Dreamy
142. Hiroshi Yoshimura - Music for Nine Post Cards = Mood: Deep, Nostalgic | Time: Morning | Energy: Calm, Cozy
143. Grimes - Visions = Mood: Trippy, Eerie | Time: Night | Energy: Energetic, Weird
144. Cybotron - Enter = Mood: Euphoric, Trippy | Time: Night | Energy: Energetic, Groovy
145. Boards of Canada - MHTRTC = Mood: Trippy, Nostalgic | Time: Sunset | Energy: Dreamy, Calm
146. Omar-S - Thank You for Letting Me Be Myself = Mood: Deep, Euphoric | Time: Night | Energy: Groovy, Calm
147. Moderat - II = Mood: Deep, Melancholic | Time: Night | Energy: Energetic, Dreamy
148. Psychic TV - Force the Hand of Chance = Mood: Eerie, Trippy | Time: Night | Energy: Weird, Dark
149. Charlie - Spacer Woman = Mood: Euphoric, Trippy | Time: Night | Energy: Groovy, Dreamy
150. Cliff Martinez - Drive OST = Mood: Melancholic, Deep | Time: Night | Energy: Calm, Dark
151. Joe Smooth - Promised Land = Mood: Euphoric | Time: Night | Energy: Groovy, Energetic
152. Four Tet - New Energy = Mood: Euphoric, Deep | Time: Day | Energy: Groovy, Calm
153. Andy Stott - Faith in Strangers = Mood: Eerie, Deep | Time: Late Night | Energy: Dark, Dreamy
154. SD Laika - That's Harakiri = Mood: Eerie, Angry | Time: Night | Energy: Aggressive, Weird
155. Skee Mask - Compro = Mood: Deep, Trippy | Time: Night | Energy: Groovy, Dreamy
156. Clark - Body Riddle = Mood: Trippy, Eerie | Time: Night | Energy: Energetic, Weird
157. Monolake - Cinemascope = Mood: Deep, Eerie | Time: Night | Energy: Calm, Dark
158. The Orb - Adventures Beyond the Ultraworld = Mood: Trippy, Euphoric | Time: Late Night | Energy: Dreamy, Calm
159. Forest Swords - Engravings = Mood: Deep, Eerie | Time: Night | Energy: Dark, Dreamy
160. Bowery Electric - Beat = Mood: Deep, Melancholic | Time: Night | Energy: Dreamy, Dark
161. Chemical Brothers - Exit Planet Dust = Mood: Euphoric, Angry | Time: Night | Energy: Energetic, Groovy
162. Einstürzende Neubauten - Kollaps = Mood: Angry, Eerie | Time: Night | Energy: Aggressive, Weird
163. Darkside - Psychic = Mood: Deep, Trippy | Time: Late Night | Energy: Groovy, Dreamy
164. Bomb Rush Cyberfunk OST = Mood: Euphoric | Time: Day | Energy: Groovy, Energetic
165. Talk Talk - It's My Life = Mood: Nostalgic, Euphoric | Time: Day | Energy: Energetic, Groovy
166. Macklemore & Ryan Lewis - The Heist = Mood: Euphoric | Time: Day | Energy: Energetic, Groovy
167. Justin Timberlake - 20/20 Experience = Mood: Euphoric, Nostalgic | Time: Night | Energy: Groovy, Cozy
168. Vampire Weekend - Contra = Mood: Euphoric | Time: Day | Energy: Energetic, Cozy
169. Blur - Parklife = Mood: Euphoric, Nostalgic | Time: Day | Energy: Energetic, Groovy
170. Jamiroquai - A Funk Odyssey = Mood: Euphoric | Time: Day | Energy: Groovy, Energetic
171. Kings of Convenience - Riot on an Empty Street = Mood: Melancholic, Nostalgic | Time: Morning | Energy: Cozy, Calm
172. Lorde - Pure Heroine = Mood: Melancholic, Deep | Time: Night | Energy: Calm, Dark
173. The Weeknd - House of Balloons = Mood: Melancholic, Trippy | Time: Late Night | Energy: Dark, Groovy
174. Françoise Hardy - Le temps de l'amour = Mood: Nostalgic, Melancholic | Time: Morning | Energy: Cozy, Calm
175. Regina Spektor - Après Moi = Mood: Melancholic, Sad | Time: Sunset | Energy: Cozy, Calm
176. a-ha - Hunting High and Low = Mood: Euphoric, Melancholic | Time: Day | Energy: Energetic, Groovy
177. Electric Light Orchestra = Mood: Euphoric, Nostalgic | Time: Day | Energy: Energetic, Groovy
178. Michael Jackson - Thriller = Mood: Euphoric | Time: Night | Energy: Groovy, Energetic
179. Tricky - Maxinquaye = Mood: Deep, Eerie | Time: Night | Energy: Dark, Groovy
180. Ulver - Kveldssanger = Mood: Deep, Sad | Time: Morning | Energy: Calm, Dark
181. The White Birch - Star Is Just a Sun = Mood: Melancholic, Sad | Time: Morning | Energy: Calm, Dreamy
182. Wilco - Yankee Hotel Foxtrot = Mood: Melancholic, Nostalgic | Time: Morning | Energy: Cozy, Dreamy
183. Wild Nothing - Nocturne = Mood: Melancholic, Nostalgic | Time: Night | Energy: Dreamy, Groovy
184. Atoms for Peace - Amok = Mood: Trippy, Deep | Time: Night | Energy: Groovy, Weird
185. Battles - Mirrored = Mood: Euphoric, Trippy | Time: Day | Energy: Energetic, Weird
186. The Brian Jonestown Massacre - Take It From the Man! = Mood: Trippy, Angry | Time: Sunset | Energy: Energetic, Dreamy
187. Los Campesinos! - Hello Sadness = Mood: Sad, Euphoric | Time: Day | Energy: Energetic, Cozy
188. Cap'n Jazz - Analphabetapolothology = Mood: Euphoric, Angry | Time: Day | Energy: Energetic, Aggressive
189. Mac DeMarco - 2 = Mood: Nostalgic, Euphoric | Time: Sunset | Energy: Cozy, Groovy
190. Death in June - All Pigs Must Die = Mood: Eerie, Deep | Time: Night | Energy: Dark, Calm
191. The Departure - Dirty Words = Mood: Melancholic, Angry | Time: Night | Energy: Dark, Energetic
192. Flying Lotus - Cosmogramma = Mood: Trippy, Euphoric | Time: Night | Energy: Energetic, Weird
193. Foals - Total Life Forever = Mood: Euphoric, Melancholic | Time: Sunset | Energy: Energetic, Groovy
194. Forseti - Erd = Mood: Deep, Eerie | Time: Sunset | Energy: Calm, Dark
195. The Go-Betweens - 16 Lovers Lane = Mood: Nostalgic, Melancholic | Time: Morning | Energy: Cozy, Calm
196. The Human League - Dare = Mood: Euphoric | Time: Night | Energy: Groovy, Energetic
197. Jethro Tull - Songs from the Wood = Mood: Nostalgic, Euphoric | Time: Morning | Energy: Cozy, Energetic
198. The Libertines - The Libertines = Mood: Euphoric, Angry | Time: Day | Energy: Energetic, Aggressive
199. Low - I Could Live in Hope = Mood: Sad, Deep | Time: Late Night | Energy: Calm, Dark
200. Mastodon - Crack the Skye = Mood: Deep, Angry | Time: Night | Energy: Aggressive, Energetic
201. Neurosis - The Eye of Every Storm = Mood: Deep, Eerie | Time: Night | Energy: Aggressive, Dark
202. New Order - Power, Corruption & Lies = Mood: Euphoric, Melancholic | Time: Night | Energy: Groovy, Energetic
203. Of Monsters and Men - My Head Is an Animal = Mood: Euphoric, Nostalgic | Time: Day | Energy: Energetic, Cozy
204. Orange Juice - You Can't Hide Your Love Forever = Mood: Euphoric, Nostalgic | Time: Day | Energy: Groovy, Cozy
205. Okkervil River - The Stage Names = Mood: Melancholic, Deep | Time: Sunset | Energy: Cozy, Energetic
206. Kurt Vile - Wakin on a Pretty Daze = Mood: Nostalgic, Trippy | Time: Sunset | Energy: Cozy, Dreamy
207. Wavves - King of the Beach = Mood: Euphoric | Time: Day | Energy: Energetic, Groovy
208. Windir - 1184 = Mood: Angry, Deep | Time: Night | Energy: Aggressive, Energetic
209. The xx - xx = Mood: Melancholic, Sad | Time: Night | Energy: Calm, Dark
210. Bombay Bicycle Club - I Had the Blues = Mood: Euphoric, Melancholic | Time: Day | Energy: Energetic, Cozy
211. Buckethead - Whitewash = Mood: Trippy, Deep | Time: Night | Energy: Weird, Energetic
212. The Decemberists - The King Is Dead = Mood: Nostalgic, Euphoric | Time: Morning | Energy: Cozy, Energetic
213. Editors - The Back Room = Mood: Melancholic, Angry | Time: Night | Energy: Dark, Energetic
214. Gojira - The Way of All Flesh = Mood: Angry, Deep | Time: Night | Energy: Aggressive, Energetic
215. Hot Chip - In Our Heads = Mood: Euphoric | Time: Night | Energy: Groovy, Energetic
216. Holy Ghost! - Holy Ghost! = Mood: Euphoric | Time: Night | Energy: Groovy, Energetic
217. Opeth - Blackwater Park = Mood: Deep, Eerie | Time: Night | Energy: Aggressive, Dark
218. Phoenix - Bankrupt! = Mood: Euphoric | Time: Day | Energy: Energetic, Groovy
219. Two Door Cinema Club - Tourist History = Mood: Euphoric | Time: Day | Energy: Energetic, Groovy
220. White Lies - To Lose My Life = Mood: Melancholic, Sad | Time: Night | Energy: Dark, Energetic
221. Grizzly Knows No Remorse - Bearotica = Mood: Euphoric, Angry | Time: Day | Energy: Energetic, Aggressive
222. Porcupine Tree - Fear of a Blank Planet = Mood: Deep, Melancholic | Time: Night | Energy: Dark, Calm
223. Travis - The Man Who = Mood: Melancholic, Nostalgic | Time: Sunset | Energy: Cozy, Calm
224. Tyler, the Creator - Wolf = Mood: Trippy, Euphoric | Time: Day | Energy: Groovy, Weird
225. The Vaccines - What Did You Expect = Mood: Euphoric | Time: Day | Energy: Energetic, Groovy
226. Au Pairs - Playing with a Different Sex = Mood: Angry, Euphoric | Time: Day | Energy: Energetic, Aggressive
227. Letta Mbulu - In the Music the Village Never Ends = Mood: Euphoric, Deep | Time: Day | Energy: Groovy, Cozy
228. Holograms - Holograms = Mood: Angry, Eerie | Time: Night | Energy: Dark, Energetic
229. Grace Jones - Nightclubbing = Mood: Deep, Euphoric | Time: Night | Energy: Groovy, Dark
230. David Bowie - Low = Mood: Deep, Melancholic | Time: Night | Energy: Dreamy, Dark
231. Fela Kuti - Roforofo Night = Mood: Euphoric, Trippy | Time: Night | Energy: Groovy, Energetic
232. The Future Sound of London - Lifeforms = Mood: Trippy, Deep | Time: Late Night | Energy: Dreamy, Calm
233. Frank Zappa - Hot Rats = Mood: Euphoric, Trippy | Time: Day | Energy: Energetic, Weird
234. Aäkon Këëtrëh - The Dark Winter = Mood: Eerie, Deep | Time: Night | Energy: Dark, Calm
235. Stereolab - Emperor Tomato Ketchup = Mood: Euphoric, Trippy | Time: Day | Energy: Groovy, Energetic
236. Fun Fun - Have Fun = Mood: Euphoric | Time: Night | Energy: Groovy, Energetic
237. HTRK - Psychic 9-5 Club = Mood: Melancholic, Eerie | Time: Late Night | Energy: Dark, Calm
238. ISIS - Panopticon = Mood: Deep, Eerie | Time: Night | Energy: Aggressive, Dark
239. Scott Walker - Scott 2 = Mood: Deep, Melancholic | Time: Night | Energy: Calm, Dark
240. Интурист - Пора стать нормальным = Mood: Nostalgic, Eerie | Time: Night | Energy: Dark, Weird
241. Sun Ra - Space Is the Place = Mood: Trippy, Euphoric | Time: Night | Energy: Weird, Energetic
242. Can - Ege Bamyasi = Mood: Trippy, Deep | Time: Night | Energy: Groovy, Weird
243. Neu! - Neu! '75 = Mood: Trippy, Euphoric | Time: Day | Energy: Groovy, Energetic
244. Funkadelic - Maggot Brain = Mood: Deep, Trippy | Time: Night | Energy: Groovy, Dark
245. Pilgrimage - Pilgrimage = Mood: Deep, Nostalgic | Time: Sunset | Energy: Calm, Cozy
246. Kyuss - Welcome to Sky Valley = Mood: Trippy, Angry | Time: Sunset | Energy: Aggressive, Groovy
247. Fu Manchu - The Action Is Go = Mood: Euphoric, Angry | Time: Day | Energy: Energetic, Aggressive
248. Hawkwind - Hall of the Mountain Grill = Mood: Trippy, Deep | Time: Night | Energy: Dreamy, Groovy
249. Have a Nice Life - Deathconsciousness = Mood: Sad, Eerie | Time: Night | Energy: Dark, Aggressive
250. Alcest - Souvenirs d'un autre monde = Mood: Melancholic, Trippy | Time: Sunset | Energy: Dreamy, Calm
251. Agalloch - Ashes Against the Grain = Mood: Deep, Melancholic | Time: Sunset | Energy: Dark, Dreamy
252. Deafheaven - Sunbather = Mood: Sad, Euphoric | Time: Sunset | Energy: Aggressive, Energetic
253. Panda Bear - Person Pitch = Mood: Euphoric, Trippy | Time: Day | Energy: Dreamy, Groovy
254. The Angelic Process - Weighing Souls with Sand = Mood: Sad, Deep | Time: Night | Energy: Dark, Dreamy
255. Slint - Spiderland = Mood: Eerie, Deep | Time: Night | Energy: Dark, Calm
256. Natural Snow Buildings - The Dance of the Moon and the Sun = Mood: Trippy, Eerie | Time: Night | Energy: Dreamy, Dark
257. Mogwai - Young Team = Mood: Deep, Sad | Time: Night | Energy: Energetic, Dreamy
258. FKA Twigs - LP1 = Mood: Deep, Melancholic | Time: Night | Energy: Dark, Groovy
259. Primal Scream - Screamadelica = Mood: Euphoric, Trippy | Time: Night | Energy: Groovy, Energetic
260. John Maus - We Must Become the Pitiless Censors of Ourselves = Mood: Eerie, Melancholic | Time: Night | Energy: Dark, Weird
261. Unwound - New Plastic Ideas = Mood: Angry, Deep | Time: Night | Energy: Energetic, Aggressive
262. XTC - Skylarking = Mood: Nostalgic, Euphoric | Time: Day | Energy: Cozy, Groovy
263. The Radio Dept. - Lesser Matters = Mood: Melancholic, Nostalgic | Time: Sunset | Energy: Dreamy, Calm
264. Joy Division - Unknown Pleasures = Mood: Sad, Eerie | Time: Night | Energy: Dark, Groovy
265. Ariel Pink - pom pom = Mood: Trippy, Nostalgic | Time: Sunset | Energy: Weird, Groovy
266. Gang of Four - Entertainment! = Mood: Angry, Euphoric | Time: Day | Energy: Energetic, Groovy
267. The Feelies - Crazy Rhythms = Mood: Euphoric, Nostalgic | Time: Day | Energy: Energetic, Groovy
268. Кино - Чёрный альбом = Mood: Melancholic, Sad | Time: Night | Energy: Dark, Calm
269. Duran Duran - Rio = Mood: Euphoric | Time: Night | Energy: Groovy, Energetic
270. The Police - Reggatta de Blanc = Mood: Euphoric, Angry | Time: Day | Energy: Energetic, Groovy
271. Soft Cell - Non-Stop Erotic Cabaret = Mood: Eerie, Euphoric | Time: Night | Energy: Groovy, Dark
272. The Soft Boys - Underwater Moonlight = Mood: Euphoric, Trippy | Time: Day | Energy: Energetic, Weird
273. Darkthrone - Transilvanian Hunger = Mood: Angry, Eerie | Time: Night | Energy: Aggressive, Dark
274. Summoning - Dol Guldur = Mood: Deep, Eerie | Time: Night | Energy: Dark, Dreamy
275. The Housemartins - London 0 Hull 4 = Mood: Euphoric, Nostalgic | Time: Day | Energy: Cozy, Energetic
276. Felt - Forever Breathes the Lonely Word = Mood: Melancholic, Nostalgic | Time: Sunset | Energy: Cozy, Dreamy
277. Fields of the Nephilim - The Nephilim = Mood: Eerie, Deep | Time: Night | Energy: Dark, Aggressive
278. A Place to Bury Strangers - Exploding Head = Mood: Angry, Eerie | Time: Night | Energy: Aggressive, Dark
279. The Pop Group - For How Much Longer = Mood: Angry, Eerie | Time: Night | Energy: Aggressive, Weird
280. Nu Genea - Bar Mediterraneo = Mood: Euphoric, Nostalgic | Time: Sunset | Energy: Groovy, Cozy
281. Stand High Patrol - The Shift = Mood: Euphoric, Trippy | Time: Sunset | Energy: Groovy, Cozy
282. Asylum Party - Borderline = Mood: Melancholic, Eerie | Time: Night | Energy: Dark, Calm
283. foxtails - fawn = Mood: Melancholic, Sad | Time: Sunset | Energy: Dreamy, Calm
284. Mute Beat - In Dub = Mood: Deep, Trippy | Time: Sunset | Energy: Groovy, Calm
285. Gétatchèw Mèkurya - Éthiopiques 14 = Mood: Euphoric, Deep | Time: Day | Energy: Energetic, Weird
286. Yasuaki Shimizu - Kakashi = Mood: Trippy, Deep | Time: Night | Energy: Weird, Calm
287. The Replacements - Let It Be = Mood: Euphoric, Angry | Time: Day | Energy: Energetic, Cozy
288. Parquet Courts - Wide Awake! = Mood: Angry, Euphoric | Time: Day | Energy: Energetic, Groovy
289. Radiohead - Amnesiac = Mood: Eerie, Deep | Time: Night | Energy: Dark, Weird
290. Ty Segall - Melted = Mood: Angry, Euphoric | Time: Day | Energy: Aggressive, Energetic
291. Meshuggah - Nothing = Mood: Angry, Deep | Time: Night | Energy: Aggressive, Dark
292. Pantera - Vulgar Display of Power = Mood: Angry | Time: Day | Energy: Aggressive, Energetic
293. UNKLE - Psyence Fiction = Mood: Deep, Melancholic | Time: Night | Energy: Groovy, Dark
294. 5nizza - о5 = Mood: Euphoric, Nostalgic | Time: Day | Energy: Cozy, Groovy
295. August Burns Red - Messengers = Mood: Angry, Euphoric | Time: Day | Energy: Aggressive, Energetic
296. Field Rotation - Acoustic Tales = Mood: Deep, Melancholic | Time: Morning | Energy: Calm, Dreamy
297. Bohren & der Club of Gore - Sunset Mission = Mood: Deep, Eerie | Time: Late Night | Energy: Calm, Dark
298. Hrsta - Ghosts Will Come And Kiss Our Eyes = Mood: Deep, Eerie | Time: Night | Energy: Calm, Dreamy
299. Morphine - Cure for Pain = Mood: Deep, Melancholic | Time: Late Night | Energy: Groovy, Dark
300. Kvelertak - Mjød = Mood: Angry, Euphoric | Time: Day | Energy: Aggressive, Energetic
301. Strapping Young Lad - Possessions = Mood: Angry | Time: Day | Energy: Aggressive, Energetic
302. Megadeth - 1000 Times Goodbye = Mood: Angry, Deep | Time: Night | Energy: Aggressive, Energetic
303. Coldworld - Tortured by Solitude = Mood: Sad, Eerie | Time: Night | Energy: Dark, Dreamy
304. Jeremy Soule - Skyrim OST = Mood: Deep, Nostalgic | Time: Morning | Energy: Calm, Dreamy
305. KoRn - Follow the Leader = Mood: Angry, Eerie | Time: Night | Energy: Aggressive, Dark
306. Entschuldigung - EP = Mood: Eerie, Trippy | Time: Night | Energy: Dark, Weird
307. Мистер Малой - Буду пагибать молодым = Mood: Euphoric, Angry | Time: Night | Energy: Groovy, Energetic
308. The Beach Boys - Pet Sounds = Mood: Nostalgic, Melancholic | Time: Sunset | Energy: Cozy, Dreamy
309. Гости из будущего - Беги от меня = Mood: Euphoric, Nostalgic | Time: Day | Energy: Groovy, Energetic
310. Hi-Fi - Первый контакт = Mood: Euphoric, Nostalgic | Time: Day | Energy: Groovy, Energetic
311. Буерак - Страсть к курению = Mood: Melancholic, Nostalgic | Time: Night | Energy: Cozy, Dark
312. BADBADNOTGOOD - IV = Mood: Deep, Euphoric | Time: Night | Energy: Groovy, Calm
313. Alphaville - Forever Young = Mood: Melancholic, Nostalgic | Time: Night | Energy: Groovy, Dreamy
314. Cream Soda - Пожар = Mood: Euphoric | Time: Night | Energy: Groovy, Energetic
315. J Dilla - Donuts = Mood: Nostalgic, Deep | Time: Sunset | Energy: Groovy, Cozy
316. Dâm-Funk - 7 Days of Funk = Mood: Euphoric, Trippy | Time: Night | Energy: Groovy, Cozy
317. D'Angelo - Voodoo = Mood: Deep, Euphoric | Time: Late Night | Energy: Groovy, Cozy
318. George Clinton - Computer Games = Mood: Euphoric, Trippy | Time: Day | Energy: Groovy, Energetic
319. Anthony Naples - Orbs = Mood: Deep, Trippy | Time: Night | Energy: Groovy, Dreamy
320. Linkin Park - Meteora = Mood: Angry, Sad | Time: Day | Energy: Aggressive, Energetic
321. Death Grips - Exmilitary = Mood: Angry, Eerie | Time: Day | Energy: Aggressive, Energetic
322. Childish Gambino - Because the Internet = Mood: Melancholic, Trippy | Time: Night | Energy: Groovy, Cozy
323. Drexciya - Grava 4 = Mood: Deep, Trippy | Time: Night | Energy: Energetic, Weird
324. DJ Krush - Jaku = Mood: Deep, Melancholic | Time: Late Night | Energy: Calm, Groovy
325. Gorillaz - Gorillaz = Mood: Euphoric, Trippy | Time: Day | Energy: Groovy, Energetic
326. The Flying Lizards - The Flying Lizards = Mood: Euphoric, Eerie | Time: Night | Energy: Weird, Groovy
327. Nils Frahm - Spaces = Mood: Deep, Melancholic | Time: Late Night | Energy: Calm, Dreamy
328. Mew - And the Glass Handed Kites = Mood: Euphoric, Trippy | Time: Day | Energy: Energetic, Dreamy
329. Steve Reich - Music for 18 Musicians = Mood: Deep, Trippy | Time: Morning | Energy: Calm, Dreamy
330. Ryuichi Sakamoto - Thousand Knives = Mood: Deep, Trippy | Time: Night | Energy: Calm, Weird
331. Верасы - Музыка для всех = Mood: Euphoric, Nostalgic | Time: Day | Energy: Cozy, Groovy
332. Союз - Сила ветра = Mood: Euphoric, Nostalgic | Time: Day | Energy: Energetic, Cozy
333. Scientist - Dance of the Vampires = Mood: Trippy, Euphoric | Time: Night | Energy: Groovy, Weird
334. Fennesz - Endless Summer = Mood: Deep, Melancholic | Time: Sunset | Energy: Dreamy, Calm
335. The Necks - Silent Night = Mood: Deep, Trippy | Time: Late Night | Energy: Calm, Dreamy
336. Cranes - Loved = Mood: Melancholic, Sad | Time: Night | Energy: Dreamy, Dark
337. Sun Kil Moon - Benji = Mood: Sad, Deep | Time: Morning | Energy: Calm, Cozy
338. Beat Happening - Beat Happening = Mood: Euphoric, Nostalgic | Time: Day | Energy: Cozy, Weird
339. Xiu Xiu - Fabulous Muscles = Mood: Eerie, Sad | Time: Night | Energy: Weird, Aggressive
340. Sade - Diamond Life = Mood: Nostalgic, Melancholic | Time: Late Night | Energy: Cozy, Groovy
341. Arctic Monkeys - Whatever People Say I Am = Mood: Euphoric, Angry | Time: Night | Energy: Energetic, Groovy
342. Marvin Gaye - What's Going On = Mood: Deep, Nostalgic | Time: Sunset | Energy: Groovy, Cozy
343. American Football - American Football = Mood: Melancholic, Nostalgic | Time: Sunset | Energy: Calm, Cozy
344. Bdrmm - I Don't Know = Mood: Melancholic, Trippy | Time: Sunset | Energy: Dreamy, Calm
345. Шаййм - Радостные дни = Mood: Euphoric, Nostalgic | Time: Day | Energy: Cozy, Groovy
346. African Head Charge - Songs of Praise = Mood: Trippy, Deep | Time: Night | Energy: Groovy, Weird
347. Sunn O))) - Black One = Mood: Eerie, Deep | Time: Night | Energy: Dark, Aggressive
348. Drive Like Jehu - Yank Crime = Mood: Angry, Euphoric | Time: Day | Energy: Aggressive, Energetic
349. Acid Bath - When the Kite String Pops = Mood: Eerie, Angry | Time: Night | Energy: Aggressive, Dark
350. Slayer - God Hates Us All = Mood: Angry | Time: Night | Energy: Aggressive, Dark
351. The Pharcyde - Labcabincalifornia = Mood: Euphoric, Nostalgic | Time: Day | Energy: Groovy, Cozy
352. Guided by Voices - Bee Thousand = Mood: Euphoric, Nostalgic | Time: Day | Energy: Energetic, Cozy
353. Blind Guardian - Nightfall in Middle-Earth = Mood: Deep, Euphoric | Time: Night | Energy: Energetic, Aggressive
354. Don Caballero - What Burns Never Returns = Mood: Trippy, Angry | Time: Night | Energy: Energetic, Weird
355. Slipknot - All Hope Is Gone = Mood: Angry | Time: Night | Energy: Aggressive, Dark
356. Dinosaur Jr - You're Living All Over Me = Mood: Angry, Melancholic | Time: Day | Energy: Energetic, Aggressive
357. The Slits - Cut = Mood: Euphoric, Angry | Time: Day | Energy: Energetic, Groovy
358. Koto - Visitors = Mood: Euphoric, Trippy | Time: Night | Energy: Energetic, Groovy
359. White Stripes - Get Behind Me Satan = Mood: Angry, Euphoric | Time: Day | Energy: Energetic, Aggressive
360. Владимир Кузьмин - Ромео и Джульетта = Mood: Nostalgic, Euphoric | Time: Sunset | Energy: Cozy, Groovy
361. Старуха Мха - Rusali = Mood: Eerie, Deep | Time: Night | Energy: Dark, Calm
362. Fugazi - Fugazi = Mood: Angry, Euphoric | Time: Day | Energy: Aggressive, Energetic
363. АК-47 - Megapolice = Mood: Angry, Euphoric | Time: Night | Energy: Aggressive, Groovy
364. Comsat Angels - Sleep No More = Mood: Melancholic, Eerie | Time: Night | Energy: Dark, Calm
365. Red Lorry Yellow Lorry - Blow = Mood: Melancholic, Eerie | Time: Night | Energy: Dark, Groovy
366. Руки Вверх - Сделай погромче = Mood: Euphoric | Time: Day | Energy: Energetic, Groovy
367. New Composers - Sputnik = Mood: Trippy, Deep | Time: Night | Energy: Dreamy, Weird
368. Maximum Joy - Stretch = Mood: Euphoric, Trippy | Time: Night | Energy: Groovy, Energetic
369. James Chance & The Contortions - Buy = Mood: Angry, Euphoric | Time: Night | Energy: Aggressive, Groovy
370. Hella - Hold Your Horse Is = Mood: Trippy, Angry | Time: Day | Energy: Energetic, Weird
371. Trisomie 21 - Chapter IV = Mood: Melancholic, Eerie | Time: Night | Energy: Dark, Groovy
372. Bush Tetras - Beauty Lies = Mood: Angry, Euphoric | Time: Night | Energy: Energetic, Groovy
373. Sunny Day Real Estate - Diary = Mood: Sad, Euphoric | Time: Day | Energy: Energetic, Cozy
374. триагрутрика - Вечерний Челябинск = Mood: Euphoric | Time: Day | Energy: Groovy, Cozy
375. Жанна Агузарова - Жанна Агузарова = Mood: Euphoric, Trippy | Time: Day | Energy: Energetic, Weird
376. Mount Eerie - Clear Moon = Mood: Sad, Deep | Time: Morning | Energy: Calm, Dreamy
377. А-Студио - Джулия = Mood: Euphoric, Nostalgic | Time: Day | Energy: Energetic, Groovy
378. Hatebreed - Hatebreed = Mood: Angry | Time: Day | Energy: Aggressive, Energetic
379. Children of Bodom - Follow the Reaper = Mood: Angry, Euphoric | Time: Night | Energy: Aggressive, Energetic
380. Teardrop Explodes - Kilimanjaro = Mood: Euphoric, Trippy | Time: Day | Energy: Energetic, Groovy
381. The Drums - The Drums = Mood: Euphoric, Nostalgic | Time: Day | Energy: Energetic, Cozy
382. Despised Icon - Day of Mourning = Mood: Angry | Time: Night | Energy: Aggressive, Dark
383. Born of Osiris - The Discovery = Mood: Angry, Euphoric | Time: Day | Energy: Aggressive, Energetic
384. Chet Baker - Chet Baker Sings = Mood: Melancholic, Nostalgic | Time: Late Night | Energy: Calm, Cozy
385. Elvis Costello - This Year's Model = Mood: Angry, Euphoric | Time: Day | Energy: Energetic, Groovy
386. Best Coast - Crazy for You = Mood: Euphoric, Nostalgic | Time: Day | Energy: Cozy, Groovy
387. Caldera - One Last Glimpse = Mood: Deep, Trippy | Time: Night | Energy: Calm, Dreamy
388. Cousin - The Second Message = Mood: Deep, Trippy | Time: Night | Energy: Groovy, Dreamy
389. Priori - Pareidolia = Mood: Deep, Trippy | Time: Night | Energy: Groovy, Dreamy
390. Maara - The Ancient Truth = Mood: Deep, Melancholic | Time: Night | Energy: Calm, Dreamy
391. Djrum - Under Tangled Silence = Mood: Deep, Melancholic | Time: Late Night | Energy: Dreamy, Dark
392. Floating Points - Cascade = Mood: Deep, Euphoric | Time: Sunset | Energy: Groovy, Dreamy
393. Delano Smith - An Odyssey = Mood: Deep, Nostalgic | Time: Late Night | Energy: Groovy, Calm
394. 4 позиции Бруно - Я заказан = Mood: Eerie, Deep | Time: Night | Energy: Dark, Weird
395. второй - Свиная попутка = Mood: Eerie, Trippy | Time: Night | Energy: Weird, Dark
396. Gabor Szabo - Dreams = Mood: Trippy, Nostalgic | Time: Late Night | Energy: Calm, Groovy
397. Lizzy Mercier Descloux - Lizzy Mercier Descloux = Mood: Euphoric, Trippy | Time: Night | Energy: Groovy, Energetic
398. Quando Quango - Pigs & Battleships = Mood: Euphoric, Angry | Time: Night | Energy: Groovy, Energetic
399. Gina X Performance - Nice Mover = Mood: Eerie, Euphoric | Time: Night | Energy: Groovy, Dark
400. Lifetones - For a Reason = Mood: Trippy, Deep | Time: Sunset | Energy: Groovy, Calm
401. Idles - Ultra Mono = Mood: Angry, Euphoric | Time: Day | Energy: Aggressive, Energetic
402. Deepchord - Auratones = Mood: Deep, Trippy | Time: Late Night | Energy: Calm, Dreamy
403. Два Обреза - Шабаш радио = Mood: Eerie, Angry | Time: Night | Energy: Dark, Weird
404. Moon Duo - Mazes = Mood: Trippy, Euphoric | Time: Sunset | Energy: Groovy, Dreamy
405. Tom Tom Club - Tom Tom Club = Mood: Euphoric | Time: Day | Energy: Groovy, Energetic
406. Оле Лукойе - Запара = Mood: Trippy, Deep | Time: Night | Energy: Weird, Groovy
407. Bluestaeb & S. Fidelity - Underground Canopy = Mood: Euphoric, Deep | Time: Sunset | Energy: Groovy, Cozy
408. ETNOBOTANIKA - Leśne Duchy = Mood: Trippy, Eerie | Time: Night | Energy: Weird, Dark
409. Slowdive - Souvlaki = Mood: Melancholic, Trippy | Time: Sunset | Energy: Dreamy, Calm
410. My Bloody Valentine - Loveless = Mood: Trippy, Melancholic | Time: Sunset | Energy: Dreamy, Energetic
411. Arthur Russell - World of Echo = Mood: Deep, Melancholic | Time: Late Night | Energy: Calm, Dreamy
412. Rhythm & Sound - The Versions = Mood: Deep, Trippy | Time: Late Night | Energy: Groovy, Calm
413. Gas - Pop = Mood: Deep, Trippy | Time: Late Night | Energy: Calm, Dreamy
414. William Basinski - The Disintegration Loops I = Mood: Sad, Deep | Time: Sunset | Energy: Calm, Dreamy
415. Ночной Проспект - Сахар = Mood: Eerie, Trippy | Time: Night | Energy: Dark, Weird
416. Гражданская Оборона - Сто лет одиночества = Mood: Angry, Sad | Time: Night | Energy: Aggressive, Dark
417. Shortparis - Пасха = Mood: Eerie, Angry | Time: Night | Energy: Aggressive, Weird
418. Guf - Город дорог = Mood: Deep, Melancholic | Time: Night | Energy: Groovy, Dark
419. Муцураев = Mood: Sad, Deep | Time: Night | Energy: Calm, Dark
420. Thrice - Artist in the Ambulance = Mood: Angry, Euphoric | Time: Day | Energy: Aggressive, Energetic
421. Fra Lippo Lippi - In Silence = Mood: Melancholic, Nostalgic | Time: Night | Energy: Calm, Cozy
422. Chameleons - Script of the Bridge = Mood: Melancholic, Eerie | Time: Night | Energy: Dark, Energetic
423. Sad Lovers & Giants - Epic Garden Music = Mood: Melancholic, Eerie | Time: Night | Energy: Dark, Dreamy
424. Утро - Утро = Mood: Eerie, Deep | Time: Night | Energy: Dark, Weird
425. Cul de Sac - China Gate = Mood: Trippy, Deep | Time: Night | Energy: Dreamy, Weird
426. The Pains of Being Pure at Heart - POBPATH = Mood: Euphoric, Melancholic | Time: Day | Energy: Dreamy, Energetic
427. Air - Moon Safari = Mood: Nostalgic, Melancholic | Time: Morning | Energy: Cozy, Dreamy
428. Dorothy Ashby - Afro-Harping = Mood: Nostalgic, Deep | Time: Sunset | Energy: Calm, Groovy
429. Angelo Badalamenti - Blue Velvet OST = Mood: Eerie, Deep | Time: Night | Energy: Dark, Calm
430. Sun Ra - Space Is the Place = Mood: Trippy, Euphoric | Time: Night | Energy: Weird, Energetic
431. Little Computer People - Electro Pop = Mood: Euphoric | Time: Night | Energy: Groovy, Energetic
432. Men I Trust - Untourable Album = Mood: Melancholic, Nostalgic | Time: Sunset | Energy: Cozy, Dreamy
433. Yoko Kanno - Cowboy Bebop OST = Mood: Euphoric, Melancholic | Time: Night | Energy: Groovy, Energetic
434. Mariah - うたかたの日々 = Mood: Melancholic, Trippy | Time: Night | Energy: Dreamy, Calm
435. Sleep Research Facility - Deep Frieze = Mood: Deep, Eerie | Time: Late Night | Energy: Calm, Dark
436. Yīn Yīn - The Rabbit That Hunts Tigers = Mood: Euphoric, Trippy | Time: Day | Energy: Groovy, Energetic
437. Wooden Shjips - West = Mood: Trippy, Deep | Time: Sunset | Energy: Groovy, Dreamy
438. Pender Street Steppers - Life in the Zone = Mood: Euphoric, Deep | Time: Night | Energy: Groovy, Calm
439. Laughing Hands - Dog Photos = Mood: Trippy, Eerie | Time: Night | Energy: Weird, Dreamy
440. Світлана Няньо & Юрченко - Знаєш як? Розкажи = Mood: Nostalgic, Deep | Time: Morning | Energy: Calm, Cozy
441. Kosmischer Läufer - Volume Four = Mood: Trippy, Euphoric | Time: Sunset | Energy: Groovy, Dreamy
442. Susumu Yokota - The Boy and the Tree = Mood: Deep, Trippy | Time: Morning | Energy: Calm, Dreamy
443. Disco Inferno - D.I. Go Pop = Mood: Trippy, Melancholic | Time: Day | Energy: Energetic, Weird
444. James Ferraro - Marble Surf = Mood: Trippy, Eerie | Time: Night | Energy: Weird, Dreamy
445. Parannoul - To See the Next Part of the Dream = Mood: Sad, Euphoric | Time: Sunset | Energy: Energetic, Dreamy
446. Sweet Trip - You Will Never Know Why = Mood: Euphoric, Trippy | Time: Day | Energy: Dreamy, Energetic
447. Hooverphonic - A New Stereophonic Sound Spectacular = Mood: Melancholic, Trippy | Time: Night | Energy: Dreamy, Cozy
448. Aphex Twin - Drukqs = Mood: Trippy, Eerie | Time: Night | Energy: Weird, Calm
449. Nightmares on Wax - Smokers Delight = Mood: Euphoric, Trippy | Time: Late Night | Energy: Groovy, Cozy
450. Amorphis - Tales from the Thousand Lakes = Mood: Deep, Melancholic | Time: Night | Energy: Aggressive, Dark
451. Lil Yachty - Let's Start Here = Mood: Trippy, Euphoric | Time: Day | Energy: Dreamy, Groovy
452. Jay Munly - Jimmy Carter Syndrome = Mood: Eerie, Sad | Time: Night | Energy: Dark, Calm
453. DJ Cam - Soulshine = Mood: Nostalgic, Deep | Time: Late Night | Energy: Groovy, Calm
454. Veil of Maya - The Common Man's Collapse = Mood: Angry | Time: Day | Energy: Aggressive, Energetic
455. Полумягкие - Акустические морали овердрафта = Mood: Melancholic, Nostalgic | Time: Sunset | Energy: Cozy, Calm
456. Kunteynir - Блёвбургер = Mood: Eerie, Angry | Time: Night | Energy: Weird, Aggressive
457. Atreyu - The Curse = Mood: Angry, Sad | Time: Night | Energy: Aggressive, Energetic
458. A Day to Remember - What Separates Me from You = Mood: Angry, Euphoric | Time: Day | Energy: Aggressive, Energetic
459. Noumena - Anatomy of Life = Mood: Melancholic, Angry | Time: Night | Energy: Aggressive, Dark
460. Global Communication - 76:14 = Mood: Deep, Trippy | Time: Late Night | Energy: Calm, Dreamy
461. Various - Sweet as Broken Dates = Mood: Nostalgic, Deep | Time: Sunset | Energy: Groovy, Cozy
462. Hugh Masekela - Home Is Where the Music Is = Mood: Euphoric, Nostalgic | Time: Day | Energy: Groovy, Energetic
463. DJ Metatron - This Is Not = Mood: Euphoric, Deep | Time: Late Night | Energy: Groovy, Dreamy
464. K-Klass - Universal = Mood: Euphoric | Time: Night | Energy: Groovy, Energetic
465. Mad Professor & Massive Attack - No Protection = Mood: Deep, Trippy | Time: Night | Energy: Groovy, Dark
466. Electric Wizard - Dopethrone = Mood: Eerie, Trippy | Time: Night | Energy: Aggressive, Dark
467. King Gizzard - 12 Bar Bruise = Mood: Euphoric, Angry | Time: Day | Energy: Energetic, Aggressive
468. Various - Doing It in Lagos = Mood: Euphoric, Nostalgic | Time: Day | Energy: Groovy, Energetic
469. In Flames - The Jester Race = Mood: Melancholic, Angry | Time: Night | Energy: Aggressive, Energetic
470. Condry Ziqubu - Gorilla Man = Mood: Euphoric, Nostalgic | Time: Day | Energy: Groovy, Energetic
471. The Chills - Kaleidoscope World = Mood: Melancholic, Nostalgic | Time: Day | Energy: Cozy, Dreamy
472. Don Laka - Stages of Love = Mood: Euphoric, Nostalgic | Time: Night | Energy: Groovy, Cozy
473. King Tubby - Dub from the Roots = Mood: Trippy, Deep | Time: Night | Energy: Groovy, Calm
474. Far East Family Band - Parallel World = Mood: Trippy, Deep | Time: Night | Energy: Dreamy, Calm
475. The Bug - London Zoo = Mood: Angry, Eerie | Time: Night | Energy: Aggressive, Dark
476. Tangerine Dream - Phaedra = Mood: Trippy, Deep | Time: Late Night | Energy: Dreamy, Calm
477. Thelonious Monk - Brilliant Corners = Mood: Euphoric, Deep | Time: Night | Energy: Groovy, Weird
478. Yusef Lateef - Love Theme from Spartacus = Mood: Deep, Nostalgic | Time: Late Night | Energy: Calm, Cozy
479. Huerco S. - For Those of You Who Have Never = Mood: Deep, Melancholic | Time: Late Night | Energy: Calm, Dreamy
480. Oneohtrix Point Never - Replica = Mood: Eerie, Trippy | Time: Night | Energy: Weird, Calm
481. Benighted - Asylum Cave = Mood: Angry | Time: Night | Energy: Aggressive, Dark
482. Pink Turns Blue - If Two Worlds Kiss = Mood: Melancholic, Eerie | Time: Night | Energy: Dark, Dreamy
483. Curtis Mayfield - Superfly = Mood: Euphoric, Deep | Time: Day | Energy: Groovy, Cozy
484. Nick Cave & the Bad Seeds - Murder Ballads = Mood: Eerie, Deep | Time: Night | Energy: Dark, Weird
485. Speedy G - Ginger = Mood: Euphoric, Deep | Time: Night | Energy: Groovy, Energetic
486. Josef K - Revelations = Mood: Angry, Melancholic | Time: Night | Energy: Energetic, Dark
487. Pixies - Doolittle = Mood: Euphoric, Angry | Time: Day | Energy: Energetic, Aggressive
488. Weezer - Weezer = Mood: Euphoric, Nostalgic | Time: Day | Energy: Energetic, Cozy
489. The Smiths - The Queen Is Dead = Mood: Melancholic, Sad | Time: Sunset | Energy: Cozy, Groovy
490. The Cure - Seventeen Seconds = Mood: Melancholic, Eerie | Time: Night | Energy: Dark, Dreamy