


Hip-Hop
Arts the Beatdoctor - Transitions
Kanye West - My Beautiful Dark Twisted Fantasy
Kendrick Lamar - good kid, m.A.A.d city
Apollo Brown - Clouds 
Wu-Tang Clan - Enter the Wu-Tang (36 Chambers)
Кровосток [Krovostok] - Студень 
Method Man & Redman - Blackout! 
Snoop Doggy Dogg - Doggystyle
Nas - Illmatic 
Black Star - Mos Def & Talib Kweli Are Black Star 
Army of the Pharaohs - Ritual of Battle
Run the Jewels - Run the Jewels 2
A$AP Rocky - LiveLoveA$AP
A tribe called quest – Low End Theory
Доброе Чувство Птицу ЕМЪ
Михей и Джуманджи Сука любовь 
Black on Both Sides Mos Def
 The Infamous Mobb Deep
Ready to Die The Notorious B.I.G.
Антоха МС -  От всей души
Kid Cudi Man Moon
Coldcut  True Skool
Madlib - Shades Of Blue
Kaytranada  - 99.9%
Run DMC - Raising hell
OutKast Stankonia 
Eminem - The Eminem Show
MF Doom - Operation Doomsday
Big L - Lifestylez Da Poor And Dangerous
50 Cent – Get Rich or Die Tryin’
Warren G -  Regulate G Funk Era 
cypress hill - cypress hill
CunninLynguists - A Piece of Strange 
Yo La Tengo - I Can Hear the Heart Beating as One 
Animal Collective - Merriweather Post Pavilion
The Avalanches - Since I Left You 
Beach House - Bloom 
Chromatics - Kill for Love
Pulp - Different Class 
Elliott Smith - Either / Or 
Swans - Children of God 
Spiritualized® - Ladies and Gentlemen We Are Floating in Space 
Ride - Nowhere 
The Antlers - Hospice 
Bon Iver - Bon Iver, Bon Iver 
The Magnetic Fields - 69 Love Songs 
Pavement - Crooked Rain, Crooked Rain 
The National - Boxer 
The Stone Roses - The Stone Roses 
Acid House Kings - Sing Along With Acid House Kings
Arcade Fire - The Suburbs
Aztec Camera - High Land, Hard Rain 
Belle and Sebastian - If You're Feeling Sinister 
The Church - Starfish 
John Coltrane - Blue Train
The Divine Comedy - Casanova
Eels - Electro-Shock Blues
Donald Fagen - The Nightfly 
Fleet Foxes - Fleet Foxes 
Foxygen - We Are the 21st Century Ambassadors of Peace & Magic
Girls - Father, Son, Holy Ghost 
Grizzly Bear - Veckatimest 
Joy Division - Unknown Pleasures 
Kraftwerk - Die Mensch-Maschine 
Kyuss - Kyuss [Welcome to Sky Valley] 
LCD Soundsystem - Sound of Silver 
Liars - Liars 
Lightning Bolt - Wonderful Rainbow 
Magazine - Real Life 
Modest Mouse - The Lonesome Crowded West 
Purity Ring - Shrines
The Radio Dept. - Lesser Matters
Royal Blood - Royal Blood 
Savages - Silence Yourself 
The Sisters of Mercy - First and Last and Always 
Sixteen Horsepower - Low Estate 
The Soft Moon - The Soft Moon 
Sonic Youth - Sister
Spiritual Front - Armageddon Gigolo'
The Strokes - Is This It 
The Tallest Man on Earth - The Wild Hunt 
Tame Impala - Lonerism 
Post-Punk / Rock / Experimental 
Godspeed You Black Emperor! - Lift Yr. Skinny Fists Like Antennas to Heaven!
Television - Marquee Moon 
Wire - Pink Flag
Claps - Wreck 
The Fall - Perverted by Language
Interpol - Turn on the Bright Lights 
Killing Joke - Night Time
Liquid Liquid - Liquid Liquid 
Bark Psychosis - Hex 
Bauhaus - In the Flat Field
Swell Maps - A Trip to Marineville 

Liliput – Liliput
Talking Heads - Remain in Light 
DIIV - Oshin 
The Durutti Column - The Return of The Durutti Column 
Tortoise
toe - The Book About My Idle Plot on a Vague Anxiety 
Explosions in the Sky - The Earth Is Not a Cold Dead Place
Lush - Split 
Pale Saints - The Comforts of Madness 
You Slut! - Critical Meat 
If These Trees Could Talk - Above the Earth, Below the Sky 
Classic Rock / Metal
The Velvet Underground & Nico - The Velvet Underground & Nico 
Tom Waits - Mule Variations
The Clash - London Calling
King Crimson - In the Court of the Crimson King 
Morphine - Cure for Pain
Atheist - Unquestionable Presence
Dire Straits - Dire Straits 
At the Drive-In - Relationship of Command 
Sleep's Holy Mountain
Iggy Pop - The Idiot
Jeff Buckley - Grace
Fleetwood Mac - Rumours 
Peter Gabriel - So 
Cocteau Twins  - Heaven or Las Vegas 
 Electronic / Ambient /
Massive Attack - Blue Lines
Coil - Horse Rotorvator 
Nujabes - Metaphorical Music 
Clams Casino - Instrumentals
Washed Out - Life of Leisure
Kraftwerk - Electric Cafe 
Pet Shop Boys - Please
SBTRKT - SBTRKT

Emancipator - Safe in the Steep Cliffs
Biosphere - Substrata
Effective Force – Diamond Bullet
Venetian Snares - Rossz csillag alatt született 
The Caretaker — Everywhere at the end 
Manuel Göttsching – E2-E4
Midori Takada – Through The Looking Glass
Thievery Corporation - Sounds From The 
It's Album Time Todd Terje
Black Celebration Depeche Mode
Silent Shout The Knife
Burial Untrue (Hyperdub, 2007)
Brian Eno Before And After Science
Pet Shop Boys  One More Chance
Caribou  Can't Do Without You
Alexander Robotnick  Problems de amour
D Train – Music
 Yazoo
Arthur Russel - Love Is Overtaking Me
Metro Area - Metro Area
Bob Moses  Days Gine By
DJ Shadow Endtroducing.....
Autechre Amber
Hiroshi Yoshimura
Grimes - Visions
Cybotron – Enter
Boards Of Canada
Omar-S – Thank You For Letting Me Be Myself
Substrata Biosphere
II Moderat
Psychic TV
Charlie Spacer Woman
Cliff Martinez – Drive 
Joe Smooth Promised Land
Four Tet New Energy
Andy Stott Faith In Strangers
Gas Pop
Sd Laika -  Meshes
Skee Mask - Compro
Clark - Cave dog 
Monolake - Cinemascope
The Orb -  The Orb's Adventures Beyond The Ultraworld
Forest Swords Engravings
Bowery Electric - Beat 
Chemical Brothers - Exit Planet Dust 
Einstürzende Neubauten -  Kollaps 
Darkside - Psychic
Bomb Rush Cyberfunk OST 

Mainstream / Pop 
Talk Talk - It's My Life 
Macklemore & Ryan Lewis  – The Heist
Justin Timberlake - The 20/20 Experience 
Vampire Weekend - Contra 
Blur - Parklife
Jamiroquai - A Funk Odyssey 
Kings of Convenience - Riot on an Empty Street 
Lorde - Pure Heroine 
he Weeknd - House of Balloons 
Francoise Hardy  Le temps de l'amour
Regina Spektor Après Moi
a-ha – Hunting High And Low
Electric Light Orchestra
Thriller Michael
Tricky - Maxinquaye 
Ulver - Kveldssanger 
The White Birch - Star Is Just a Sun ???
Wilco - Yankee Hotel Foxtrot 
Wild Nothing - Nocturne
Atoms for Peace - Amok
Battles - Mirrored 
The Brian Jonestown Massacre - Take It From the Man! 
Los Campesinos! - Hello Sadness 
Cap n jazz -  Analphabetapolothology
Mac DeMarco - 2
Death in June - All Pigs Must Die 
The Departure - Dirty Words
Flying Lotus - Cosmogramma
Foals Total Life Forever
Forseti - Erd
The Go-Betweens - 16 Lovers Lane 
The Human League - Dare (1
Jethro Tull - Songs From the Wood 
The Libertines - The Libertines 
Low - I Could Live in Hope 
Mastodon - Crack the Skye 
Neurosis - The Eye of Every Storm
New Order - Power, Corruption & Lies
Of Monsters and Men - My Head Is an Animal 
Orange Juice - You Can't Hide Your Love Forever 
Okkervil River - The Stage Names 
Kurt Vile - Wakin on a Pretty Daze 
Wavves - King of the Beach
Windir - 1184 
The xx - xx 
Bombay Bicycle Club - I Had the Blues But I Shook Them Loose (
Buckethead Whitewash
The Decemberists - The King Is Dead (
Editors - The Back Room (
Gojira - The Way of All Flesh 
Hot Chip - In Our Heads 
Holy Ghost! - Holy Ghost!
Opeth - Blackwater Park 
Phoenix - Bankrupt! 
Slaughterhouse - Slaughterhouse 
Two Door Cinema Club - Tourist History 
White Lies - To Lose My Life (
Grizzly Knows No Remorse - Bearotica (
Porcupine Tree - Fear of a Blank Planet (
Travis - The Man Who 
Tyler, the Creator - Wolf 
The Vaccines - What Did You Expect From The Vaccines? 
Playing with a Different Sex Au Pairs
Letta Mbulu – In the Music village never ends
Holograms - Holograms
Grace Jones - Nightclubbing
David Bowie Low 
Fela Kuti Roforofo Night
The Future Sound Of London – Lifeforms 
Frank Zappa - Hot Rats
Aäkon Këëtrëh - The Dark Winter
Stereolab – Emperor Tomato Ketchup
Fun Fun – Have Fun
HTRK - Psychic 9-5 Club
ISIS - Panopticon 
Scott - Walker Scott 2
Интурист - Пора стать нормальным
Sun Ra 
Can - Ege barmashi
NEU! '75
Funkadelic - Maggot Brain
Pilgrimage
Kyuss -  Welcome to Sky Valley
The Action Is Go Fu Manchu
 Hawkwind - Hall of the Mountain Grill 
Have a Nice Life -Deathconsciousness
Alcest - Souvenirs d'un autre monde
Agalloch - Ashes Against The Grain

Sunbather Deafheaven
Panda Bear - Person Pitch 
Weighing Souls With Sand The Angelic Process
Slint - Spiderland 
Bark Psychosis - Hex
Natural Snow Buildings  - The Dance of the Moon and the Sun 
Mogwai -  Young Team
FKA twigs - LP1
Screamadelica Primal Scream
John Maus -We Must Become the Pitiless Censors of Ourselves  
Unwound - New Plastic Ideas
XTC - Skylarkin
The Radio Dept. - Lesser Matters 
Joy Division -  Unknown Pleasures 
pom pom ariel pink
Gang of Four - Entertainment!
The Feelies - Crazy Rhythms 
Кино - (Чёрный альбом)
Duran Duran - Rio 
The police - Reggatta de blanc  
Soft Cell - Non-Stop Erotic Cabaret 
The Soft Boys - Underwater Moonlight 
Darkthrone - Transilvanian Hunger 
Summoning - Dol Guldur 
The Housemartins - London 0 Hull 4 
Felt - Forever Breathes the Lonely Word
Fields of the Nephilim - The Nephilim 
A Place to Bury Strangers - Exploding Head 
The Pop Group - For How Much Longer Do We Tolerate Mass Murder?
Nu Genea - Bar Mediterraneo 
Stand High Patrol - The Shift
Asylum Party – Borderline
foxtails - fawn
Mute Beat -  "In Dub"
Gétatchèw Mèkurya - Éthiopiques 14: Negus of Ethiopian Sax
Yasuaki Shimizu – Kakashi
The Replacements - Let It Be 
Parquet Courts Wide Awake!
Radiohead - Amnesiac 
Ty Segall - Melted 
Low I Could Live In Hope
Meshuggah - Nothing
Pantera - Vulgar Display Of Power 
UNKLE - Psyence Fiction 
5nizza  - о5
August Burns Red - Messengers 
Field Rotation – Acoustic Tales
Bohren Der Club of Gore - Sunset Mission
Hrsta - Ghosts Will Come And Kiss Our Eyes 
morphine - cure for pain
Kvelertak -  Mjød
Strapping Young Lad -  Possessions
Megadeth - 1000 Times Goodbye
Coldworld -  Tortured By Solitude
Jeremy Soule - Skyrim
KoRn - follow the leader 
Entschuldigung - EP
Мистер Малой - буду пагибать молодым 
The Beach Boys - Pet sounds 
Гости из будущего - беги от меня 
Hi-Fi – Первый Контакт
Буерак -  Страсть к курению
BADBADNOTGOOD -  IV 
Alphaville - Forever Young
Cream Soda - Пожар
J Dilla - Donuts
Dâm-Funk - 7 days of Funk
D'Angelo -  Voodoo
George Clinton - Computer Games
Anthony Naples - orbs 
Linkin Park – Meteora 
Death Grips - Exmilitary
Childish Gambino  - Because The Internet
Drexciya - Grava 4
DJ Krush - Jaku 
Gorillaz Gorillaz
The Flying Lizards – The Flying Lizards
Nils Frahm - Spaces 
Mew - And the Glass Handed Kites
Steve Reich - Music For 18 Musicians
Ryuichi Sakamoto - thousand Knives of 
Верасы - Музыка для всех
Союз - Сила Ветра
Scientist - Dance Of The Vampires 
Fennesz - Endless Summer
The Necks - Silent Night
Cranes  - Loved 
Sun Kil Moon - Benji
Beat Happening - beat happeing
Xiu Xiu - Fabulous Muscles 
Sade - Diamond Life
Arctic Monkeys – Whatever People Say I Am, That's What I'm Not
Marvin Gaye  - whats going on
American Football -  American Football
Bdrmm - I dont Know 
Шаййм - радостные дни 
African Head Charge - Songs Of Praise
Sunn 0))) - Black One 
Drive Like Jehu
Acid Bath  - When The Kite Strings Pop
Slayer - God Hate Us All
Labcabincalifornia  - The Pharcyde - 
Guided by Voices 
Blind Guardian  - Nightfall in middle earth 
Don Caballero - What burns never returns 
Slipknot - All hope is gone 
Dinosaur Jr - You`re Living all over me
Slits - cut
Koto - Visitors
At The Drive In -  Relationship Of Command
 White Stripes – Get Behind Me Satan
МС Сенечка
Владимир Кузьмин - Ромео И Джульетта
Старуха Мха - rusali 
Fugazi -  fugaze
АК 47 - Megapolice
Comsat Angels  - sleep no more 
Red Lorry Yellow Lorry - Blow 
Руки Вверх - Сделай погромче
New Composers - Sputnik
Maximum Joy - stretch
James Chance& The Contortions - buy
Hella - Hold Your Horse Is
Trisomie 21 - Chapter IV ~ Le Je-Ne-Sais-Quoi Et Le Presque Rien ~ 




Bush Tetras - beauty lies 
Sunny day real estate  - diary 
триагрутрика - вечерний челябинск
Oxxxymiron - вечный жид
Жанна Агузарова – Жанна Агузарова
Mount Eerie - clear moon 
А студио - джулия 
Hatebreed - hatebreed 
Children of bodom - follow the leader
Teardrop Explodes - Kilimanjaro 



the drums - the drums 
despised icon - day of mourning
born of osiris - the discovery 
Chet Baker - chet baker singns
Elvis Costello - This Year's Model
 Best coast - crazy for you  
caldera - one last glimpse 
cousin - the second message
priori - Pareidolia
maara - The Ancient Truth
djrum - Under Tangled Silence
floating points - cascade 
four tet - new energy 
delano smith -  An Odyssey
4 позиции бруно - я заказан 
второй ка свиная попутка
gabor szabo — dreams  
Lizzy Mercier Descloux - Lizzy Mercier Descloux
Quando Quango - Pigs & Battleships
Gina Perfomance - Nice Mover
Lifetones - For A Reason
Idles - ultra mono 
Deepchord - auratones 
Два Обреза - шабаш радио
Moon Duo - Mazes
Tom Tom Club - tom tom club
Оле Лукойе - запара
Bluestaeb & S. Fidelity Present Underground  -Canopy
ETNOBOTANIKA - Leśne Duchy 
Slowdive  - soulvake
My Bloody Valentine- loveless
Arthur Russell — World of Echo
Basic Channel - 
Rhythm & Sound — The Versions
Gas - Pop
William Basinski — The Disintegration Loops I
Ночной Проспект — Сахар
Гражданская Оборона — Сто лет одиночества
Shortparis — Пасха
Guf - Город Дорог
Муцураев
Thrice - Artist In Ambulance
Fra Lippo Lippi - in silence
Chameleons - script of the bridge
sad lovers giants - epic garden music
